....................
....................
....................
....................
....................
....................
....................
.........GGG........
.........###........
....................
....GGG...A...GGG...
....###..###..###...
....................
.1................X.
####################
