............G....................#......
.................................#......
.................................#......
.................................#......
.................................#......
.............G...................#......
.................................#......
.........G.......................#......
.................................#......
.................................#......
.1....................#..........#......
......................#.................
...G.G.G..............#.................
......................#......A........X.
#########..#########..##################
